WWWWWW WWWWWW
W W    W    W
W W   WW    W
W      WWW  W
WWW      W  W
W   W       W
WW  WWW  WWWW
W   W       W
WWWWWW WWWWWW