WWWWWW WWWWWW
W W    W    W
W W WWWW    W
W      WWW  W
WWW      W  W
W   W       W
WW  WWW  WWWW
W   W       W
W   W       W
W         WWW
W   W       W
WWWWWW WWWWWW